@@@@@@@@@@@@@@@@@@@@@@@@@@@@
@............@@............@
@.@@@@.@@@@@.@@.@@@@@.@@@@.@
@!@  @.@   @.@@.@   @.@  @!@
@.@@@@.@@@@@.@@.@@@@@.@@@@.@
@..........................@
@.@@@@.@@.@@@@@@@@.@@.@@@@.@
@.@@@@.@@.@@@@@@@@.@@.@@@@.@
@......@@....@@....@@......@
@@@@@@.@@@@@ @@ @@@@@.@@@@@@
     @.@@@@@ @@ @@@@@.@
     @.@@          @@.@
     @.@@ @@@--@@@ @@.@
@@@@@@.@@ @------@ @@.@@@@@@
1     .   @------@   .     2 
@@@@@@.@@ @------@ @@.@@@@@@
     @.@@ @@@@@@@@ @@.@
     @.@@     %    @@.@
     @.@@ @@@@@@@@ @@.@
@@@@@@.@@ @@@@@@@@ @@.@@@@@@
@............@@............@
@.@@@@.@@@@@.@@.@@@@@.@@@@.@
@.@@@@.@@@@@.@@.@@@@@.@@@@.@
@!..@@.......P........@@..!@
@@@.@@.@@.@@@@@@@@.@@.@@.@@@
@@@.@@.@@.@@@@@@@@.@@.@@.@@@
@......@@....@@....@@......@
@.@@@@@@@@@@.@@.@@@@@@@@@@.@
@.@@@@@@@@@@.@@.@@@@@@@@@@.@
@..........................@
@@@@@@@@@@@@@@@@@@@@@@@@@@@@