9999999999999999999999999999
9888888888888998888888888889
9899998999998998999998999989
979  989   989989   989  979
9899998999998998999998999989
9888888888888888888888888889
9899998998999999998998999989
9899998998999999998998999989
9888888998888998888998888889
999999899999 99 999998999999
     9899999 99 9999989
     9899          9989
     9899 999  999 9989
999999899 9      9 998999999
X     8   9 0123 9   8     Y
999999899 9      9 998999999
     9899 99999999 9989
     9899     6    9989
     9899 99999999 9989
999999899 99999999 998999999
9888888888888998888888888889
9899998999998998999998999989
9899998999998998999998999989
9788998888888P88888888998879
9998998998999999998998998999
9998998998999999998998998999
9888888998888998888998888889
9899999999998998999999999989
9899999999998998999999999989
9888888888888888888888888889
9999999999999999999999999999
